0000000000000000000000000000078889
0
0000000000000000000000000000000000000000000000000516
0000000000000000000000000000000000000000000000000324
0000000000000000000000000000000000000000000000000324
000000000000000000000000000000000000000000000000ea24
51600000000000000007889000000000051600000000051ca224
3240000000000000000000000000000003240000000003222224
32bf0000000000000000000000005111ca2bf000000003222224
322bd6000000000000000000000032222222bd111111ca222224
322224000000000000000000000ea22222222222222222222224
32222bd1111111111111111111ca222222222222222222222224
3222222222222222222222222222222222222222222222222224
3222222222222222222222222222222222222222222222222224
3222222222222222222222222222222222222222222222222224
3222222222222222222222222222222222222222222222222224
giiiiiiiiiiiiiiiiiiiiiiiiiiiiiiiiiiiiiiiiiiiiiiiiiih